class,name,kor,eng,mat,bio,total,avg
1,adam,67,87,90,98,342,85.5
1,andrew,45,45,56,98,244,61.0
1,ben,95,59,96,88,338,84.5
1,clark,65,94,89,98,346,86.5
1,dan,45,65,78,98,286,71.5
1,noel,78,76,98,89,341,85.25
2,paul,87,67,65,56,275,68.75
2,walter,89,98,78,78,343,85.75
2,oscar,100,78,56,65,299,74.75
2,martin,99,89,87,87,362,90.5
2,hugh,98,45,56,54,253,63.25
2,henry,65,89,87,78,319,79.75
